D__#####_#__###
_#_____#_##_#__
__##_#___#____#
#___####___####
___#_____###__#
##_####_##___##
___###_____####
_#___##_#_#___#
_##_#___#___###
###__####_#####
###_##_#__##__#
#___#__#_##__##
__##__#_____###
#_##__##_##_###
#____###__#___A